111111111111111111111111-
100000000001100000000001-
101110111101101111011101-
121110111101101111011121-
100000000000000000000001-
101110110111111011011101-
100000110001100011000001-
1111101111*11*1111011111-
11111011********11011111-
11111011*1****1*11011111-
*****0***1****1***0*****-
11111011*111111*11011111-
11111011********11011111-
11111011*111111*11011111-
100000000001100000000001-
101110111101101111011101-
1200100000****0000010021-
111010101111111101010111-
100000100001100001000001-
101111111101101111111101-
100000000000000000000001-
111111111111111111111111