111111111*111111111-
120000001*100000021-
1011011010101101101-
1010000000000000101-
1000110110110110001-
1010100000000010101-
1010001111111000101-
1000102*****2010001-
1110101*****1010111-
**001011111110100**-
1110101111111010111-
1000000*****0000001-
101101101*101101101-
101101101*101101101-
1000000010100000001-
1011011000001101101-
1011011010101101101-
120000001*100000021-
111111111*111111111