111111111111111111111111-
100000100000000001000001-
101110101111111101011101-
121110101000000101011121-
100000101011110101000001-
101011101011110101110101-
101000000011110000000101-
1011101*11111111*1011101-
1000001**********1000001-
1101111*111**111*1111011-
1100001*1******1*1000011-
1101101*11111111*1011011-
1101100*00000000*0011011-
1101111*11111111*1111011-
110000000011110000000011-
110111101011110101111011-
**00001010000001010000**-
110110101011110101011011-
100110100011110001011001-
121110101111111101011121-
100000000000000000000001-
111111111111111111111111